date,over_correct,over_predicted,under_correct,under_predicted,total_predicted
2024-03-29,9,13,20,38,51
2024-03-27,3,4,13,20,24
2024-03-28,1,1,2,4,5
2024-03-30,0,1,4,6,7
2024-03-31,5,7,8,25,32
2024-04-01,2,3,9,13,16
2024-04-02,2,8,9,15,23
2024-04-03,2,4,6,16,20
2024-04-04,3,6,6,15,21
2024-04-05,0,4,11,20,24
2024-04-06,0,0,2,5,5
